111111111111111111111
10000000000C000000001
100000000000000C10101
1100E0010P01000010111
10000C0C0000000000001
111111111111111111111
